PID,Name,Priority,Burst Time,Arrival Time,Waiting Time,Response Time
1,(syste,20,1927,0,40943,42870
2,(kthre,20,5,0,12,17
3,(rcu_g,0,0,0,1932,1932
4,(rcu_p,0,0,0,1932,1932
5,(slub_,0,0,0,1932,1932
6,(netns,0,0,0,1932,1932
10,(mm_pe,0,0,0,1932,1932
11,(rcu_t,20,0,0,1932,1932
12,(rcu_t,20,0,0,1932,1932
13,(rcu_t,20,0,0,1932,1932
14,(ksoft,20,1847,0,40272,42119
15,(rcu_p,20,2609,0,45738,48347
16,(migra,-100,438,0,21240,21678
17,(idle_,-51,0,0,6826,6826
19,(cpuhp,20,0,0,6826,6826
20,(kdevt,20,1,0,53,54
21,(inet_,0,0,0,6827,6827
22,(kaudi,20,1,0,54,55
23,(khung,20,42,0,3707,3749
24,(oom_r,20,0,0,6870,6870
27,(write,0,0,0,6870,6870
28,(kcomp,20,1517,0,37375,38892
29,(ksmd),25,0,0,8387,8387
30,(khuge,39,0,0,8387,8387
31,(kinte,0,0,0,8387,8387
32,(kbloc,0,0,0,8387,8387
33,(blkcg,0,0,0,8387,8387
34,(tpm_d,0,0,0,8387,8387
35,(ata_s,0,0,0,8387,8387
36,(md),0,0,0,8387,8387
37,(edac-,0,0,0,8387,8387
38,(devfr,0,0,0,8387,8387
39,(watch,-51,0,0,8387,8387
40,(kwork,0,182,0,12717,12899
41,(kswap,20,433,0,21258,21691
42,(ecryp,20,0,0,9002,9002
43,(kthro,0,0,0,9002,9002
44,(acpi_,0,0,0,9002,9002
45,(scsi_,20,33,0,2702,2735
46,(scsi_,0,0,0,9035,9035
47,(scsi_,20,11,0,115,126
48,(scsi_,0,0,0,9046,9046
53,(mld),0,0,0,9046,9046
54,(ipv6_,0,0,0,9046,9046
61,(kstrp,0,0,0,9046,9046
63,(zswap,0,0,0,9046,9046
64,(kwork,0,0,0,9046,9046
68,(charg,0,0,0,9046,9046
107,(scsi_,20,6,0,126,132
108,(scsi_,0,0,0,9052,9052
118,(kwork,0,3535,0,51287,54822
139,(jbd2/,20,285,0,16629,16914
140,(ext4-,0,0,0,12872,12872
179,(syste,19,758,0,27828,28586
210,(irq/1,-51,0,0,13630,13630
225,(syste,20,486,0,22387,22873
281,(crypt,0,0,0,14116,14116
504,(syste,20,16424,0,79423,95847
505,(syste,20,482,0,22405,22887
506,(syste,20,147,0,10966,11113
551,(accou,20,76,0,6529,6605
552,(acpid,20,81,0,6533,6614
555,(avahi,20,692,0,26536,27228
556,(cron),20,52,0,4826,4878
557,(dbus-,20,1028,0,31912,32940
558,(Netwo,20,5554,0,59781,65335
565,(netwo,20,255,0,15858,16113
566,(polki,20,1321,0,35502,36823
567,(power,20,28,0,2891,2919
568,(rsysl,20,25,0,2895,2920
570,(snapd,20,813,0,28694,29507
571,(switc,20,31,0,2908,2939
572,(syste,20,326,0,18331,18657
573,(udisk,20,244,0,15456,15700
574,(wpa_s,20,242,0,15460,15702
613,(avahi,20,0,0,41937,41937
658,(cupsd,20,109,0,8990,9099
661,(unatt,20,210,0,14004,14214
667,(Modem,20,135,0,10419,10554
714,(gdm3),20,56,0,4962,5018
765,(cups-,20,53,0,4970,5023
774,(kerne,20,25,0,3011,3036
776,(kerne,20,25,0,3012,3037
866,(rtkit,21,17,0,1856,1873
1002,(upowe,20,61,0,5850,5911
1022,(packa,20,379,0,19817,20196
1180,(color,20,168,0,11748,11916
1249,(gdm-s,20,176,0,12361,12537
1262,(syste,20,696,0,26592,27288
1263,((sd-p,20,0,0,44047,44047
1269,(pipew,9,39,0,4097,4136
1270,(pipew,20,47,0,4100,4147
1271,(pulse,9,296,0,17196,17492
1279,(dbus-,20,529,0,23487,24016
1284,(gvfsd,20,36,0,3121,3157
1289,(gvfsd,20,9,0,612,621
1307,(xdg-d,20,20,0,1981,2001
1309,(gnome,20,46,0,4135,4181
1314,(xdg-p,20,7,0,645,652
1320,(fuser,20,4,0,652,656
1330,(gdm-w,20,7,0,656,663
1333,(gnome,20,97,0,8341,8438
1374,(gnome,20,14,0,2013,2027
1394,(gnome,20,118,0,9087,9205
1415,(gnome,20,49727,0,79431,129158
1416,(at-sp,20,21,0,2039,2060
1428,(dbus-,20,27,0,3181,3208
1465,(gnome,20,187,0,12983,13170
1467,(gvfs-,20,115,0,9121,9236
1472,(gvfs-,20,31,0,3208,3239
1485,(evolu,20,206,0,14070,14276
1486,(gvfs-,20,13,0,2108,2121
1490,(gvfs-,20,17,0,2109,2126
1494,(goa-d,20,155,0,11197,11352
1504,(goa-i,20,46,0,4229,4275
1506,(gvfs-,20,18,0,2138,2156
1520,(evolu,20,208,0,14072,14280
1525,(gvfsd,20,59,0,5155,5214
1539,(at-sp,20,19,0,2168,2187
1540,(gjs),20,93,0,7649,7742
1549,(sh),20,4,0,891,895
1550,(gsd-a,20,9,0,895,904
1556,(gsd-c,20,231,0,15069,15300
1557,(ibus-,20,421,0,21131,21552
1561,(gsd-d,20,47,0,4299,4346
1563,(gsd-h,20,368,0,19509,19877
1564,(gsd-k,20,136,0,10590,10726
1565,(gsd-m,20,219,0,14616,14835
1566,(gsd-p,20,161,0,11904,12065
1575,(gsd-p,20,30,0,3371,3401
1576,(gsd-r,20,14,0,2283,2297
1577,(gsd-s,20,7,0,1012,1019
1578,(gsd-s,20,36,0,3377,3413
1583,(gsd-s,20,16,0,2297,2313
1586,(gsd-s,20,21,0,2301,2322
1587,(gsd-w,20,144,0,10618,10762
1595,(evolu,20,378,0,19872,20250
1597,(dconf,20,22,0,2334,2356
1617,(evolu,20,66,0,6127,6193
1637,(ibus-,20,16,0,2356,2372
1639,(ibus-,20,1178,0,33940,35118
1642,(gsd-d,20,12,0,1127,1139
1660,(ibus-,20,13,0,2372,2385
1669,(gsd-p,20,30,0,3437,3467
1692,(snapd,20,72,0,6145,6217
1795,(snapd,20,282,0,16866,17148
1799,(xdg-d,20,75,0,6986,7061
1804,(ibus-,20,112,0,9284,9396
1809,(snap-,20,4319,0,55230,59549
1812,(xdg-d,20,186,0,13110,13296
1851,(track,39,922,0,30462,31384
1903,(gjs),20,95,0,7826,7921
1939,(gjs),20,907,0,30287,31194
1947,(xdg-d,20,156,0,11364,11520
1991,(gvfsd,20,17,0,2505,2522
2117,(gnome,20,382,0,19926,20308
2119,(seaho,20,299,0,17324,17623
2126,(gnome,20,5164,0,58649,63813
2220,(bash),20,222,0,14727,14949
2658,(updat,20,164,0,12041,12205
4148,(kwork,20,14316,0,77323,91639
4448,(kwork,20,0,0,127527,127527
4449,(kwork,20,1132,0,33408,34540
4471,(kwork,20,379,0,19972,20351
4474,(kwork,20,111,0,9444,9555
4481,(kwork,20,0,0,129149,129149
4482,(kwork,20,0,0,129149,129149
4505,(main),20,9,0,1403,1412

Average Waiting Time: 15039.92
Average Response Time: 15808.71
